Doctor Who Locations

Adipose 3 - Home of Adipose
Alfava Metraxis - Byzantium
Apalapucia - Timeline mess
Asylum of the Daleks - This other place
Bank of Karabraxos - Super Bank
Church of the Silence - This place
Clom - Homeworld of Abzorbaloff
Demon's Run - Asteroid Base
Earth - Human homeworld
Gallifrey - Time Lord homeworld
Hedgewick’s World Of Wonders - Amusement park
House - TARDIS trap planet
Krillia - Homeworld of Krillitanes
Krop Tor - Satan planet
Messaline - Jenny's home
Midnight - Diamond planet
Mars - Bad water
Moon - Martha hospital trip
New Earth - Future human planet
Ood Sphere - Ood home planet
Orient Express - Space train
Pyrovilia - Pyrovile home planet
Raxacoricofallapatorius - Slitheen homeworld
Rings of Akhaten - Super sun
San Helios - Desert planet
Satellite 5 - Space station above Earth, Bad Wolf Showdown location
Skaro - Dalek homeworld
Shan-Shen - Market fortune teller
Silurian Ark - Dinosaurs
Sontar - Sontaran homeworld
Starship UK - Spaceship
The Library - Vashta Nerada
Titanic - Replica ship, in space
Trenzalore - Grave/Christmas